GGGGGGGGGGGGGGGGGGGG
GSSSSSSSSSSSSSSSSSGG
GGSGGGGGGGGGGGGGGSSG
GGSGGGGGGGGGGGGGGGSG
GGSGGGGGGGGGGGGGGGSG
GGSGGGGGGGGGGGGGGGSG
GGSGGGGGGGGGGGGGGGSG
GGSGGGGGGGGGGGGGGGSG
GGSGGGGGGGGGGGGGGGSG
GGSGGGGGGGGGGGGGGGSG
GGSGGGGGGGGGGGGGGGSG
GGSGGGGGGGGGGGGGGGSG
GGSGGGGGGGGGGGGGGGSG
GGSGGGGGGGGGGGGGGGSG
GGSGGGGGGGGGGGGGGGSG
GGSGGGGGGGGGGGGGGGSG
GGSGGGGGGGGGGGGGGGSG
GGSGGGGGGGGGGGGGGGSG
GGSSSSSSSSSSSSSSSSSG
GGGGGGGGGGGGGGGGGGGG